#,#,#,#,#,#,.,#,.,.,.,#
#,.,#,.,.,#,.,#,#,#,.,#
#,.,#,.,.,.,.,.,.,#,.,#
#,.,#,.,.,#,#,#,#,#,.,#
#,.,.,#,.,.,.,.,.,.,.,#
#,.,.,.,#,.,#,#,.,.,.,#
#,.,.,.,.,#,.,.,.,.,.,#
#,.,.,.,.,#,.,.,.,.,.,#
#,.,.,.,.,.,.,.,.,.,.,#
#,#,#,#,#,#,#,#,#,.,.,#
